Epi_date_V3,Year,Cases,7-Day Average,Cumulative Cases,AsOf
5/10/2022,2022,1,0,1,Data as Reported to CDC as of 05 Jul 2023 2:00 PM EDT
5/11/2022,2022,5,0,6,Data as Reported to CDC as of 05 Jul 2023 2:00 PM EDT
5/12/2022,2022,0,0,6,Data as Reported to CDC as of 05 Jul 2023 2:00 PM EDT
5/13/2022,2022,0,0,6,Data as Reported to CDC as of 05 Jul 2023 2:00 PM EDT
5/14/2022,2022,0,0,6,Data as Reported to CDC as of 05 Jul 2023 2:00 PM EDT
5/15/2022,2022,2,0,8,Data as Reported to CDC as of 05 Jul 2023 2:00 PM EDT
5/16/2022,2022,7,2.142857074737549,15,Data as Reported to CDC as of 05 Jul 2023 2:00 PM EDT
5/17/2022,2022,3,2.4285714626312256,18,Data as Reported to CDC as of 05 Jul 2023 2:00 PM EDT
5/18/2022,2022,2,2,20,Data as Reported to CDC as of 05 Jul 2023 2:00 PM EDT
5/19/2022,2022,3,2.4285714626312256,23,Data as Reported to CDC as of 05 Jul 2023 2:00 PM EDT
5/20/2022,2022,0,2.4285714626312256,23,Data as Reported to CDC as of 05 Jul 2023 2:00 PM EDT
5/21/2022,2022,1,2.5714285373687744,24,Data as Reported to CDC as of 05 Jul 2023 2:00 PM EDT
5/22/2022,2022,1,2.4285714626312256,25,Data as Reported to CDC as of 05 Jul 2023 2:00 PM EDT
5/23/2022,2022,3,1.8571428060531616,28,Data as Reported to CDC as of 05 Jul 2023 2:00 PM EDT
5/24/2022,2022,4,2,32,Data as Reported to CDC as of 05 Jul 2023 2:00 PM EDT
5/25/2022,2022,2,2,34,Data as Reported to CDC as of 05 Jul 2023 2:00 PM EDT
5/26/2022,2022,2,1.8571428060531616,36,Data as Reported to CDC as of 05 Jul 2023 2:00 PM EDT
5/27/2022,2022,4,2.4285714626312256,40,Data as Reported to CDC as of 05 Jul 2023 2:00 PM EDT
5/28/2022,2022,0,2.2857143878936768,40,Data as Reported to CDC as of 05 Jul 2023 2:00 PM EDT
5/29/2022,2022,6,3,46,Data as Reported to CDC as of 05 Jul 2023 2:00 PM EDT
5/30/2022,2022,8,3.7142856121063232,54,Data as Reported to CDC as of 05 Jul 2023 2:00 PM EDT
5/31/2022,2022,5,3.857142925262451,59,Data as Reported to CDC as of 05 Jul 2023 2:00 PM EDT
6/1/2022,2022,9,4.857142925262451,68,Data as Reported to CDC as of 05 Jul 2023 2:00 PM EDT
6/2/2022,2022,13,6.4285712242126465,81,Data as Reported to CDC as of 05 Jul 2023 2:00 PM EDT
6/3/2022,2022,7,6.857142925262451,88,Data as Reported to CDC as of 05 Jul 2023 2:00 PM EDT
6/4/2022,2022,5,7.5714287757873535,93,Data as Reported to CDC as of 05 Jul 2023 2:00 PM EDT
6/5/2022,2022,6,7.5714287757873535,99,Data as Reported to CDC as of 05 Jul 2023 2:00 PM EDT
6/6/2022,2022,20,9.285714149475098,119,Data as Reported to CDC as of 05 Jul 2023 2:00 PM EDT
6/7/2022,2022,19,11.285714149475098,138,Data as Reported to CDC as of 05 Jul 2023 2:00 PM EDT
6/8/2022,2022,12,11.714285850524902,150,Data as Reported to CDC as of 05 Jul 2023 2:00 PM EDT
6/9/2022,2022,6,10.714285850524902,156,Data as Reported to CDC as of 05 Jul 2023 2:00 PM EDT
6/10/2022,2022,24,13.142857551574707,180,Data as Reported to CDC as of 05 Jul 2023 2:00 PM EDT
6/11/2022,2022,11,14,191,Data as Reported to CDC as of 05 Jul 2023 2:00 PM EDT
6/12/2022,2022,25,16.714284896850586,216,Data as Reported to CDC as of 05 Jul 2023 2:00 PM EDT
6/13/2022,2022,25,17.428571701049805,241,Data as Reported to CDC as of 05 Jul 2023 2:00 PM EDT
6/14/2022,2022,26,18.428571701049805,267,Data as Reported to CDC as of 05 Jul 2023 2:00 PM EDT
6/15/2022,2022,33,21.428571701049805,300,Data as Reported to CDC as of 05 Jul 2023 2:00 PM EDT
6/16/2022,2022,26,24.285715103149414,326,Data as Reported to CDC as of 05 Jul 2023 2:00 PM EDT
6/17/2022,2022,33,25.571428298950195,359,Data as Reported to CDC as of 05 Jul 2023 2:00 PM EDT
6/18/2022,2022,27,27.85714340209961,386,Data as Reported to CDC as of 05 Jul 2023 2:00 PM EDT
6/19/2022,2022,36,29.428571701049805,422,Data as Reported to CDC as of 05 Jul 2023 2:00 PM EDT
6/20/2022,2022,42,31.85714340209961,464,Data as Reported to CDC as of 05 Jul 2023 2:00 PM EDT
6/21/2022,2022,43,34.28571319580078,507,Data as Reported to CDC as of 05 Jul 2023 2:00 PM EDT
6/22/2022,2022,62,38.42856979370117,569,Data as Reported to CDC as of 05 Jul 2023 2:00 PM EDT
6/23/2022,2022,56,42.71428680419922,625,Data as Reported to CDC as of 05 Jul 2023 2:00 PM EDT
6/24/2022,2022,49,45,674,Data as Reported to CDC as of 05 Jul 2023 2:00 PM EDT
6/25/2022,2022,55,49,729,Data as Reported to CDC as of 05 Jul 2023 2:00 PM EDT
6/26/2022,2022,66,53.28571319580078,795,Data as Reported to CDC as of 05 Jul 2023 2:00 PM EDT
6/27/2022,2022,97,61.14285659790039,892,Data as Reported to CDC as of 05 Jul 2023 2:00 PM EDT
6/28/2022,2022,90,67.85713958740234,982,Data as Reported to CDC as of 05 Jul 2023 2:00 PM EDT
6/29/2022,2022,78,70.14286041259766,1060,Data as Reported to CDC as of 05 Jul 2023 2:00 PM EDT
6/30/2022,2022,115,78.57142639160156,1175,Data as Reported to CDC as of 05 Jul 2023 2:00 PM EDT
7/1/2022,2022,138,91.28571319580078,1313,Data as Reported to CDC as of 05 Jul 2023 2:00 PM EDT
7/2/2022,2022,127,101.57142639160156,1440,Data as Reported to CDC as of 05 Jul 2023 2:00 PM EDT
7/3/2022,2022,131,110.85713958740234,1571,Data as Reported to CDC as of 05 Jul 2023 2:00 PM EDT
7/4/2022,2022,162,120.14286041259766,1733,Data as Reported to CDC as of 05 Jul 2023 2:00 PM EDT
7/5/2022,2022,184,133.57142639160156,1917,Data as Reported to CDC as of 05 Jul 2023 2:00 PM EDT
7/6/2022,2022,179,148,2096,Data as Reported to CDC as of 05 Jul 2023 2:00 PM EDT
7/7/2022,2022,183,157.7142791748047,2279,Data as Reported to CDC as of 05 Jul 2023 2:00 PM EDT
7/8/2022,2022,245,173,2524,Data as Reported to CDC as of 05 Jul 2023 2:00 PM EDT
7/9/2022,2022,192,182.2857208251953,2716,Data as Reported to CDC as of 05 Jul 2023 2:00 PM EDT
7/10/2022,2022,221,195.14285278320312,2937,Data as Reported to CDC as of 05 Jul 2023 2:00 PM EDT
7/11/2022,2022,347,221.57142639160156,3284,Data as Reported to CDC as of 05 Jul 2023 2:00 PM EDT
7/12/2022,2022,236,229,3520,Data as Reported to CDC as of 05 Jul 2023 2:00 PM EDT
7/13/2022,2022,277,243,3797,Data as Reported to CDC as of 05 Jul 2023 2:00 PM EDT
7/14/2022,2022,303,260.1428527832031,4100,Data as Reported to CDC as of 05 Jul 2023 2:00 PM EDT
7/15/2022,2022,353,275.5714416503906,4453,Data as Reported to CDC as of 05 Jul 2023 2:00 PM EDT
7/16/2022,2022,258,285,4711,Data as Reported to CDC as of 05 Jul 2023 2:00 PM EDT
7/17/2022,2022,248,288.8571472167969,4959,Data as Reported to CDC as of 05 Jul 2023 2:00 PM EDT
7/18/2022,2022,412,298.1428527832031,5371,Data as Reported to CDC as of 05 Jul 2023 2:00 PM EDT
7/19/2022,2022,327,311.1428527832031,5698,Data as Reported to CDC as of 05 Jul 2023 2:00 PM EDT
7/20/2022,2022,369,324.28570556640625,6067,Data as Reported to CDC as of 05 Jul 2023 2:00 PM EDT
7/21/2022,2022,335,328.8571472167969,6402,Data as Reported to CDC as of 05 Jul 2023 2:00 PM EDT
7/22/2022,2022,355,329.1428527832031,6757,Data as Reported to CDC as of 05 Jul 2023 2:00 PM EDT
7/23/2022,2022,308,336.28570556640625,7065,Data as Reported to CDC as of 05 Jul 2023 2:00 PM EDT
7/24/2022,2022,329,347.8571472167969,7394,Data as Reported to CDC as of 05 Jul 2023 2:00 PM EDT
7/25/2022,2022,517,362.8571472167969,7911,Data as Reported to CDC as of 05 Jul 2023 2:00 PM EDT
7/26/2022,2022,408,374.4285583496094,8319,Data as Reported to CDC as of 05 Jul 2023 2:00 PM EDT
7/27/2022,2022,460,387.4285583496094,8779,Data as Reported to CDC as of 05 Jul 2023 2:00 PM EDT
7/28/2022,2022,426,400.4285583496094,9205,Data as Reported to CDC as of 05 Jul 2023 2:00 PM EDT
7/29/2022,2022,456,414.8571472167969,9661,Data as Reported to CDC as of 05 Jul 2023 2:00 PM EDT
7/30/2022,2022,371,423.8571472167969,10032,Data as Reported to CDC as of 05 Jul 2023 2:00 PM EDT
7/31/2022,2022,359,428.1428527832031,10391,Data as Reported to CDC as of 05 Jul 2023 2:00 PM EDT
8/1/2022,2022,642,446,11033,Data as Reported to CDC as of 05 Jul 2023 2:00 PM EDT
8/2/2022,2022,475,455.5714416503906,11508,Data as Reported to CDC as of 05 Jul 2023 2:00 PM EDT
8/3/2022,2022,448,453.8571472167969,11956,Data as Reported to CDC as of 05 Jul 2023 2:00 PM EDT
8/4/2022,2022,447,456.8571472167969,12403,Data as Reported to CDC as of 05 Jul 2023 2:00 PM EDT
8/5/2022,2022,488,461.4285583496094,12891,Data as Reported to CDC as of 05 Jul 2023 2:00 PM EDT
8/6/2022,2022,388,463.8571472167969,13279,Data as Reported to CDC as of 05 Jul 2023 2:00 PM EDT
8/7/2022,2022,350,462.5714416503906,13629,Data as Reported to CDC as of 05 Jul 2023 2:00 PM EDT
8/8/2022,2022,509,443.5714416503906,14138,Data as Reported to CDC as of 05 Jul 2023 2:00 PM EDT
8/9/2022,2022,414,434.8571472167969,14552,Data as Reported to CDC as of 05 Jul 2023 2:00 PM EDT
8/10/2022,2022,472,438.28570556640625,15024,Data as Reported to CDC as of 05 Jul 2023 2:00 PM EDT
8/11/2022,2022,409,432.8571472167969,15433,Data as Reported to CDC as of 05 Jul 2023 2:00 PM EDT
8/12/2022,2022,403,420.71429443359375,15836,Data as Reported to CDC as of 05 Jul 2023 2:00 PM EDT
8/13/2022,2022,354,415.8571472167969,16190,Data as Reported to CDC as of 05 Jul 2023 2:00 PM EDT
8/14/2022,2022,311,410.28570556640625,16501,Data as Reported to CDC as of 05 Jul 2023 2:00 PM EDT
8/15/2022,2022,475,405.4285583496094,16976,Data as Reported to CDC as of 05 Jul 2023 2:00 PM EDT
8/16/2022,2022,328,393.1428527832031,17304,Data as Reported to CDC as of 05 Jul 2023 2:00 PM EDT
8/17/2022,2022,342,374.5714416503906,17646,Data as Reported to CDC as of 05 Jul 2023 2:00 PM EDT
8/18/2022,2022,405,374,18051,Data as Reported to CDC as of 05 Jul 2023 2:00 PM EDT
8/19/2022,2022,400,373.5714416503906,18451,Data as Reported to CDC as of 05 Jul 2023 2:00 PM EDT
8/20/2022,2022,343,372,18794,Data as Reported to CDC as of 05 Jul 2023 2:00 PM EDT
8/21/2022,2022,277,367.1428527832031,19071,Data as Reported to CDC as of 05 Jul 2023 2:00 PM EDT
8/22/2022,2022,349,349.1428527832031,19420,Data as Reported to CDC as of 05 Jul 2023 2:00 PM EDT
8/23/2022,2022,361,353.8571472167969,19781,Data as Reported to CDC as of 05 Jul 2023 2:00 PM EDT
8/24/2022,2022,307,348.8571472167969,20088,Data as Reported to CDC as of 05 Jul 2023 2:00 PM EDT
8/25/2022,2022,318,336.4285583496094,20406,Data as Reported to CDC as of 05 Jul 2023 2:00 PM EDT
8/26/2022,2022,318,324.71429443359375,20724,Data as Reported to CDC as of 05 Jul 2023 2:00 PM EDT
8/27/2022,2022,237,309.5714416503906,20961,Data as Reported to CDC as of 05 Jul 2023 2:00 PM EDT
8/28/2022,2022,238,304,21199,Data as Reported to CDC as of 05 Jul 2023 2:00 PM EDT
8/29/2022,2022,311,298.5714416503906,21510,Data as Reported to CDC as of 05 Jul 2023 2:00 PM EDT
8/30/2022,2022,268,285.28570556640625,21778,Data as Reported to CDC as of 05 Jul 2023 2:00 PM EDT
8/31/2022,2022,229,274.1428527832031,22007,Data as Reported to CDC as of 05 Jul 2023 2:00 PM EDT
9/1/2022,2022,340,277.28570556640625,22347,Data as Reported to CDC as of 05 Jul 2023 2:00 PM EDT
9/2/2022,2022,280,271.8571472167969,22627,Data as Reported to CDC as of 05 Jul 2023 2:00 PM EDT
9/3/2022,2022,194,265.71429443359375,22821,Data as Reported to CDC as of 05 Jul 2023 2:00 PM EDT
9/4/2022,2022,163,255,22984,Data as Reported to CDC as of 05 Jul 2023 2:00 PM EDT
9/5/2022,2022,236,244.2857208251953,23220,Data as Reported to CDC as of 05 Jul 2023 2:00 PM EDT
9/6/2022,2022,274,245.14285278320312,23494,Data as Reported to CDC as of 05 Jul 2023 2:00 PM EDT
9/7/2022,2022,229,245.14285278320312,23723,Data as Reported to CDC as of 05 Jul 2023 2:00 PM EDT
9/8/2022,2022,239,230.7142791748047,23962,Data as Reported to CDC as of 05 Jul 2023 2:00 PM EDT
9/9/2022,2022,215,221.42857360839844,24177,Data as Reported to CDC as of 05 Jul 2023 2:00 PM EDT
9/10/2022,2022,172,218.2857208251953,24349,Data as Reported to CDC as of 05 Jul 2023 2:00 PM EDT
9/11/2022,2022,107,210.2857208251953,24456,Data as Reported to CDC as of 05 Jul 2023 2:00 PM EDT
9/12/2022,2022,245,211.57142639160156,24701,Data as Reported to CDC as of 05 Jul 2023 2:00 PM EDT
9/13/2022,2022,193,200,24894,Data as Reported to CDC as of 05 Jul 2023 2:00 PM EDT
9/14/2022,2022,181,193.14285278320312,25075,Data as Reported to CDC as of 05 Jul 2023 2:00 PM EDT
9/15/2022,2022,183,185.14285278320312,25258,Data as Reported to CDC as of 05 Jul 2023 2:00 PM EDT
9/16/2022,2022,175,179.42857360839844,25433,Data as Reported to CDC as of 05 Jul 2023 2:00 PM EDT
9/17/2022,2022,137,174.42857360839844,25570,Data as Reported to CDC as of 05 Jul 2023 2:00 PM EDT
9/18/2022,2022,119,176.14285278320312,25689,Data as Reported to CDC as of 05 Jul 2023 2:00 PM EDT
9/19/2022,2022,137,160.7142791748047,25826,Data as Reported to CDC as of 05 Jul 2023 2:00 PM EDT
9/20/2022,2022,167,157,25993,Data as Reported to CDC as of 05 Jul 2023 2:00 PM EDT
9/21/2022,2022,136,150.57142639160156,26129,Data as Reported to CDC as of 05 Jul 2023 2:00 PM EDT
9/22/2022,2022,148,145.57142639160156,26277,Data as Reported to CDC as of 05 Jul 2023 2:00 PM EDT
9/23/2022,2022,118,137.42857360839844,26395,Data as Reported to CDC as of 05 Jul 2023 2:00 PM EDT
9/24/2022,2022,85,130,26480,Data as Reported to CDC as of 05 Jul 2023 2:00 PM EDT
9/25/2022,2022,84,125,26564,Data as Reported to CDC as of 05 Jul 2023 2:00 PM EDT
9/26/2022,2022,144,126,26708,Data as Reported to CDC as of 05 Jul 2023 2:00 PM EDT
9/27/2022,2022,106,117.28571319580078,26814,Data as Reported to CDC as of 05 Jul 2023 2:00 PM EDT
9/28/2022,2022,100,112.14286041259766,26914,Data as Reported to CDC as of 05 Jul 2023 2:00 PM EDT
9/29/2022,2022,111,106.85713958740234,27025,Data as Reported to CDC as of 05 Jul 2023 2:00 PM EDT
9/30/2022,2022,104,104.85713958740234,27129,Data as Reported to CDC as of 05 Jul 2023 2:00 PM EDT
10/1/2022,2022,85,104.85713958740234,27214,Data as Reported to CDC as of 05 Jul 2023 2:00 PM EDT
10/2/2022,2022,63,101.85713958740234,27277,Data as Reported to CDC as of 05 Jul 2023 2:00 PM EDT
10/3/2022,2022,90,94.14286041259766,27367,Data as Reported to CDC as of 05 Jul 2023 2:00 PM EDT
10/4/2022,2022,88,91.57142639160156,27455,Data as Reported to CDC as of 05 Jul 2023 2:00 PM EDT
10/5/2022,2022,85,89.42857360839844,27540,Data as Reported to CDC as of 05 Jul 2023 2:00 PM EDT
10/6/2022,2022,106,88.71428680419922,27646,Data as Reported to CDC as of 05 Jul 2023 2:00 PM EDT
10/7/2022,2022,84,85.85713958740234,27730,Data as Reported to CDC as of 05 Jul 2023 2:00 PM EDT
10/8/2022,2022,55,81.57142639160156,27785,Data as Reported to CDC as of 05 Jul 2023 2:00 PM EDT
10/9/2022,2022,72,82.85713958740234,27857,Data as Reported to CDC as of 05 Jul 2023 2:00 PM EDT
10/10/2022,2022,80,81.42857360839844,27937,Data as Reported to CDC as of 05 Jul 2023 2:00 PM EDT
10/11/2022,2022,68,78.57142639160156,28005,Data as Reported to CDC as of 05 Jul 2023 2:00 PM EDT
10/12/2022,2022,68,76.14286041259766,28073,Data as Reported to CDC as of 05 Jul 2023 2:00 PM EDT
10/13/2022,2022,68,70.71428680419922,28141,Data as Reported to CDC as of 05 Jul 2023 2:00 PM EDT
10/14/2022,2022,71,68.85713958740234,28212,Data as Reported to CDC as of 05 Jul 2023 2:00 PM EDT
10/15/2022,2022,47,67.71428680419922,28259,Data as Reported to CDC as of 05 Jul 2023 2:00 PM EDT
10/16/2022,2022,45,63.85714340209961,28304,Data as Reported to CDC as of 05 Jul 2023 2:00 PM EDT
10/17/2022,2022,61,61.14285659790039,28365,Data as Reported to CDC as of 05 Jul 2023 2:00 PM EDT
10/18/2022,2022,55,59.28571319580078,28420,Data as Reported to CDC as of 05 Jul 2023 2:00 PM EDT
10/19/2022,2022,44,55.85714340209961,28464,Data as Reported to CDC as of 05 Jul 2023 2:00 PM EDT
10/20/2022,2022,61,54.85714340209961,28525,Data as Reported to CDC as of 05 Jul 2023 2:00 PM EDT
10/21/2022,2022,56,52.71428680419922,28581,Data as Reported to CDC as of 05 Jul 2023 2:00 PM EDT
10/22/2022,2022,36,51.14285659790039,28617,Data as Reported to CDC as of 05 Jul 2023 2:00 PM EDT
10/23/2022,2022,27,48.57143020629883,28644,Data as Reported to CDC as of 05 Jul 2023 2:00 PM EDT
10/24/2022,2022,52,47.28571319580078,28696,Data as Reported to CDC as of 05 Jul 2023 2:00 PM EDT
10/25/2022,2022,43,45.57143020629883,28739,Data as Reported to CDC as of 05 Jul 2023 2:00 PM EDT
10/26/2022,2022,51,46.57143020629883,28790,Data as Reported to CDC as of 05 Jul 2023 2:00 PM EDT
10/27/2022,2022,50,45,28840,Data as Reported to CDC as of 05 Jul 2023 2:00 PM EDT
10/28/2022,2022,38,42.42856979370117,28878,Data as Reported to CDC as of 05 Jul 2023 2:00 PM EDT
10/29/2022,2022,29,41.42856979370117,28907,Data as Reported to CDC as of 05 Jul 2023 2:00 PM EDT
10/30/2022,2022,28,41.57143020629883,28935,Data as Reported to CDC as of 05 Jul 2023 2:00 PM EDT
10/31/2022,2022,47,40.85714340209961,28982,Data as Reported to CDC as of 05 Jul 2023 2:00 PM EDT
11/1/2022,2022,39,40.28571319580078,29021,Data as Reported to CDC as of 05 Jul 2023 2:00 PM EDT
11/2/2022,2022,41,38.85714340209961,29062,Data as Reported to CDC as of 05 Jul 2023 2:00 PM EDT
11/3/2022,2022,40,37.42856979370117,29102,Data as Reported to CDC as of 05 Jul 2023 2:00 PM EDT
11/4/2022,2022,32,36.57143020629883,29134,Data as Reported to CDC as of 05 Jul 2023 2:00 PM EDT
11/5/2022,2022,31,36.85714340209961,29165,Data as Reported to CDC as of 05 Jul 2023 2:00 PM EDT
11/6/2022,2022,29,37,29194,Data as Reported to CDC as of 05 Jul 2023 2:00 PM EDT
11/7/2022,2022,42,36.28571319580078,29236,Data as Reported to CDC as of 05 Jul 2023 2:00 PM EDT
11/8/2022,2022,25,34.28571319580078,29261,Data as Reported to CDC as of 05 Jul 2023 2:00 PM EDT
11/9/2022,2022,33,33.14285659790039,29294,Data as Reported to CDC as of 05 Jul 2023 2:00 PM EDT
11/10/2022,2022,29,31.571428298950195,29323,Data as Reported to CDC as of 05 Jul 2023 2:00 PM EDT
11/11/2022,2022,32,31.571428298950195,29355,Data as Reported to CDC as of 05 Jul 2023 2:00 PM EDT
11/12/2022,2022,16,29.428571701049805,29371,Data as Reported to CDC as of 05 Jul 2023 2:00 PM EDT
11/13/2022,2022,22,28.428571701049805,29393,Data as Reported to CDC as of 05 Jul 2023 2:00 PM EDT
11/14/2022,2022,36,27.571428298950195,29429,Data as Reported to CDC as of 05 Jul 2023 2:00 PM EDT
11/15/2022,2022,18,26.571428298950195,29447,Data as Reported to CDC as of 05 Jul 2023 2:00 PM EDT
11/16/2022,2022,23,25.14285659790039,29470,Data as Reported to CDC as of 05 Jul 2023 2:00 PM EDT
11/17/2022,2022,13,22.85714340209961,29483,Data as Reported to CDC as of 05 Jul 2023 2:00 PM EDT
11/18/2022,2022,31,22.714284896850586,29514,Data as Reported to CDC as of 05 Jul 2023 2:00 PM EDT
11/19/2022,2022,19,23.14285659790039,29533,Data as Reported to CDC as of 05 Jul 2023 2:00 PM EDT
11/20/2022,2022,19,22.714284896850586,29552,Data as Reported to CDC as of 05 Jul 2023 2:00 PM EDT
11/21/2022,2022,25,21.14285659790039,29577,Data as Reported to CDC as of 05 Jul 2023 2:00 PM EDT
11/22/2022,2022,17,21,29594,Data as Reported to CDC as of 05 Jul 2023 2:00 PM EDT
11/23/2022,2022,19,20.428571701049805,29613,Data as Reported to CDC as of 05 Jul 2023 2:00 PM EDT
11/24/2022,2022,17,21,29630,Data as Reported to CDC as of 05 Jul 2023 2:00 PM EDT
11/25/2022,2022,13,18.428571701049805,29643,Data as Reported to CDC as of 05 Jul 2023 2:00 PM EDT
11/26/2022,2022,14,17.714284896850586,29657,Data as Reported to CDC as of 05 Jul 2023 2:00 PM EDT
11/27/2022,2022,9,16.285715103149414,29666,Data as Reported to CDC as of 05 Jul 2023 2:00 PM EDT
11/28/2022,2022,21,15.714285850524902,29687,Data as Reported to CDC as of 05 Jul 2023 2:00 PM EDT
11/29/2022,2022,16,15.571428298950195,29703,Data as Reported to CDC as of 05 Jul 2023 2:00 PM EDT
11/30/2022,2022,14,14.857142448425293,29717,Data as Reported to CDC as of 05 Jul 2023 2:00 PM EDT
12/1/2022,2022,20,15.285714149475098,29737,Data as Reported to CDC as of 05 Jul 2023 2:00 PM EDT
12/2/2022,2022,16,15.714285850524902,29753,Data as Reported to CDC as of 05 Jul 2023 2:00 PM EDT
12/3/2022,2022,7,14.714285850524902,29760,Data as Reported to CDC as of 05 Jul 2023 2:00 PM EDT
12/4/2022,2022,11,15,29771,Data as Reported to CDC as of 05 Jul 2023 2:00 PM EDT
12/5/2022,2022,24,15.428571701049805,29795,Data as Reported to CDC as of 05 Jul 2023 2:00 PM EDT
12/6/2022,2022,10,14.571428298950195,29805,Data as Reported to CDC as of 05 Jul 2023 2:00 PM EDT
12/7/2022,2022,13,14.428571701049805,29818,Data as Reported to CDC as of 05 Jul 2023 2:00 PM EDT
12/8/2022,2022,16,13.857142448425293,29834,Data as Reported to CDC as of 05 Jul 2023 2:00 PM EDT
12/9/2022,2022,12,13.285714149475098,29846,Data as Reported to CDC as of 05 Jul 2023 2:00 PM EDT
12/10/2022,2022,12,14,29858,Data as Reported to CDC as of 05 Jul 2023 2:00 PM EDT
12/11/2022,2022,7,13.428571701049805,29865,Data as Reported to CDC as of 05 Jul 2023 2:00 PM EDT
12/12/2022,2022,16,12.285714149475098,29881,Data as Reported to CDC as of 05 Jul 2023 2:00 PM EDT
12/13/2022,2022,11,12.428571701049805,29892,Data as Reported to CDC as of 05 Jul 2023 2:00 PM EDT
12/14/2022,2022,13,12.428571701049805,29905,Data as Reported to CDC as of 05 Jul 2023 2:00 PM EDT
12/15/2022,2022,17,12.571428298950195,29922,Data as Reported to CDC as of 05 Jul 2023 2:00 PM EDT
12/16/2022,2022,17,13.285714149475098,29939,Data as Reported to CDC as of 05 Jul 2023 2:00 PM EDT
12/17/2022,2022,8,12.714285850524902,29947,Data as Reported to CDC as of 05 Jul 2023 2:00 PM EDT
12/18/2022,2022,9,13,29956,Data as Reported to CDC as of 05 Jul 2023 2:00 PM EDT
12/19/2022,2022,16,13,29972,Data as Reported to CDC as of 05 Jul 2023 2:00 PM EDT
12/20/2022,2022,12,13.142857551574707,29984,Data as Reported to CDC as of 05 Jul 2023 2:00 PM EDT
12/21/2022,2022,2,11.571428298950195,29986,Data as Reported to CDC as of 05 Jul 2023 2:00 PM EDT
12/22/2022,2022,9,10.428571701049805,29995,Data as Reported to CDC as of 05 Jul 2023 2:00 PM EDT
12/23/2022,2022,10,9.428571701049805,30005,Data as Reported to CDC as of 05 Jul 2023 2:00 PM EDT
12/24/2022,2022,5,9,30010,Data as Reported to CDC as of 05 Jul 2023 2:00 PM EDT
12/25/2022,2022,7,8.714285850524902,30017,Data as Reported to CDC as of 05 Jul 2023 2:00 PM EDT
12/26/2022,2022,8,7.5714287757873535,30025,Data as Reported to CDC as of 05 Jul 2023 2:00 PM EDT
12/27/2022,2022,4,6.4285712242126465,30029,Data as Reported to CDC as of 05 Jul 2023 2:00 PM EDT
12/28/2022,2022,6,7,30035,Data as Reported to CDC as of 05 Jul 2023 2:00 PM EDT
12/29/2022,2022,3,6.142857074737549,30038,Data as Reported to CDC as of 05 Jul 2023 2:00 PM EDT
12/30/2022,2022,5,5.4285712242126465,30043,Data as Reported to CDC as of 05 Jul 2023 2:00 PM EDT
12/31/2022,2022,5,5.4285712242126465,30048,Data as Reported to CDC as of 05 Jul 2023 2:00 PM EDT
1/1/2023,2023,11,6,30059,Data as Reported to CDC as of 05 Jul 2023 2:00 PM EDT
1/2/2023,2023,2,5.142857074737549,30061,Data as Reported to CDC as of 05 Jul 2023 2:00 PM EDT
1/3/2023,2023,10,6,30071,Data as Reported to CDC as of 05 Jul 2023 2:00 PM EDT
1/4/2023,2023,3,5.5714287757873535,30074,Data as Reported to CDC as of 05 Jul 2023 2:00 PM EDT
1/5/2023,2023,9,6.4285712242126465,30083,Data as Reported to CDC as of 05 Jul 2023 2:00 PM EDT
1/6/2023,2023,6,6.5714287757873535,30089,Data as Reported to CDC as of 05 Jul 2023 2:00 PM EDT
1/7/2023,2023,6,6.714285850524902,30095,Data as Reported to CDC as of 05 Jul 2023 2:00 PM EDT
1/8/2023,2023,8,6.285714149475098,30103,Data as Reported to CDC as of 05 Jul 2023 2:00 PM EDT
1/9/2023,2023,7,7,30110,Data as Reported to CDC as of 05 Jul 2023 2:00 PM EDT
1/10/2023,2023,10,7,30120,Data as Reported to CDC as of 05 Jul 2023 2:00 PM EDT
1/11/2023,2023,7,7.5714287757873535,30127,Data as Reported to CDC as of 05 Jul 2023 2:00 PM EDT
1/12/2023,2023,8,7.4285712242126465,30135,Data as Reported to CDC as of 05 Jul 2023 2:00 PM EDT
1/13/2023,2023,7,7.5714287757873535,30142,Data as Reported to CDC as of 05 Jul 2023 2:00 PM EDT
1/14/2023,2023,6,7.5714287757873535,30148,Data as Reported to CDC as of 05 Jul 2023 2:00 PM EDT
1/15/2023,2023,6,7.285714149475098,30154,Data as Reported to CDC as of 05 Jul 2023 2:00 PM EDT
1/16/2023,2023,4,6.857142925262451,30158,Data as Reported to CDC as of 05 Jul 2023 2:00 PM EDT
1/17/2023,2023,2,5.714285850524902,30160,Data as Reported to CDC as of 05 Jul 2023 2:00 PM EDT
1/18/2023,2023,3,5.142857074737549,30163,Data as Reported to CDC as of 05 Jul 2023 2:00 PM EDT
1/19/2023,2023,2,4.285714149475098,30165,Data as Reported to CDC as of 05 Jul 2023 2:00 PM EDT
1/20/2023,2023,11,4.857142925262451,30176,Data as Reported to CDC as of 05 Jul 2023 2:00 PM EDT
1/21/2023,2023,5,4.714285850524902,30181,Data as Reported to CDC as of 05 Jul 2023 2:00 PM EDT
1/22/2023,2023,4,4.4285712242126465,30185,Data as Reported to CDC as of 05 Jul 2023 2:00 PM EDT
1/23/2023,2023,4,4.4285712242126465,30189,Data as Reported to CDC as of 05 Jul 2023 2:00 PM EDT
1/24/2023,2023,5,4.857142925262451,30194,Data as Reported to CDC as of 05 Jul 2023 2:00 PM EDT
1/25/2023,2023,7,5.4285712242126465,30201,Data as Reported to CDC as of 05 Jul 2023 2:00 PM EDT
1/26/2023,2023,3,5.5714287757873535,30204,Data as Reported to CDC as of 05 Jul 2023 2:00 PM EDT
1/27/2023,2023,5,4.714285850524902,30209,Data as Reported to CDC as of 05 Jul 2023 2:00 PM EDT
1/28/2023,2023,5,4.714285850524902,30214,Data as Reported to CDC as of 05 Jul 2023 2:00 PM EDT
1/29/2023,2023,3,4.5714287757873535,30217,Data as Reported to CDC as of 05 Jul 2023 2:00 PM EDT
1/30/2023,2023,3,4.4285712242126465,30220,Data as Reported to CDC as of 05 Jul 2023 2:00 PM EDT
1/31/2023,2023,5,4.4285712242126465,30225,Data as Reported to CDC as of 05 Jul 2023 2:00 PM EDT
2/1/2023,2023,3,3.857142925262451,30228,Data as Reported to CDC as of 05 Jul 2023 2:00 PM EDT
2/2/2023,2023,7,4.4285712242126465,30235,Data as Reported to CDC as of 05 Jul 2023 2:00 PM EDT
2/3/2023,2023,3,4.142857074737549,30238,Data as Reported to CDC as of 05 Jul 2023 2:00 PM EDT
2/4/2023,2023,4,4,30242,Data as Reported to CDC as of 05 Jul 2023 2:00 PM EDT
2/5/2023,2023,1,3.7142856121063232,30243,Data as Reported to CDC as of 05 Jul 2023 2:00 PM EDT
2/6/2023,2023,1,3.4285714626312256,30244,Data as Reported to CDC as of 05 Jul 2023 2:00 PM EDT
2/7/2023,2023,2,3,30246,Data as Reported to CDC as of 05 Jul 2023 2:00 PM EDT
2/8/2023,2023,2,2.857142925262451,30248,Data as Reported to CDC as of 05 Jul 2023 2:00 PM EDT
2/9/2023,2023,2,2.142857074737549,30250,Data as Reported to CDC as of 05 Jul 2023 2:00 PM EDT
2/10/2023,2023,4,2.2857143878936768,30254,Data as Reported to CDC as of 05 Jul 2023 2:00 PM EDT
2/11/2023,2023,1,1.8571428060531616,30255,Data as Reported to CDC as of 05 Jul 2023 2:00 PM EDT
2/12/2023,2023,1,1.8571428060531616,30256,Data as Reported to CDC as of 05 Jul 2023 2:00 PM EDT
2/13/2023,2023,1,1.8571428060531616,30257,Data as Reported to CDC as of 05 Jul 2023 2:00 PM EDT
2/14/2023,2023,2,1.8571428060531616,30259,Data as Reported to CDC as of 05 Jul 2023 2:00 PM EDT
2/15/2023,2023,2,1.8571428060531616,30261,Data as Reported to CDC as of 05 Jul 2023 2:00 PM EDT
2/16/2023,2023,3,2,30264,Data as Reported to CDC as of 05 Jul 2023 2:00 PM EDT
2/17/2023,2023,3,1.8571428060531616,30267,Data as Reported to CDC as of 05 Jul 2023 2:00 PM EDT
2/18/2023,2023,2,2,30269,Data as Reported to CDC as of 05 Jul 2023 2:00 PM EDT
2/19/2023,2023,1,2,30270,Data as Reported to CDC as of 05 Jul 2023 2:00 PM EDT
2/20/2023,2023,2,2.142857074737549,30272,Data as Reported to CDC as of 05 Jul 2023 2:00 PM EDT
2/21/2023,2023,0,1.8571428060531616,30272,Data as Reported to CDC as of 05 Jul 2023 2:00 PM EDT
2/22/2023,2023,2,1.8571428060531616,30274,Data as Reported to CDC as of 05 Jul 2023 2:00 PM EDT
2/23/2023,2023,2,1.7142857313156128,30276,Data as Reported to CDC as of 05 Jul 2023 2:00 PM EDT
2/24/2023,2023,1,1.4285714626312256,30277,Data as Reported to CDC as of 05 Jul 2023 2:00 PM EDT
2/25/2023,2023,1,1.2857142686843872,30278,Data as Reported to CDC as of 05 Jul 2023 2:00 PM EDT
2/26/2023,2023,4,1.7142857313156128,30282,Data as Reported to CDC as of 05 Jul 2023 2:00 PM EDT
2/27/2023,2023,1,1.5714285373687744,30283,Data as Reported to CDC as of 05 Jul 2023 2:00 PM EDT
2/28/2023,2023,5,2.2857143878936768,30288,Data as Reported to CDC as of 05 Jul 2023 2:00 PM EDT
3/1/2023,2023,3,2.4285714626312256,30291,Data as Reported to CDC as of 05 Jul 2023 2:00 PM EDT
3/2/2023,2023,1,2.2857143878936768,30292,Data as Reported to CDC as of 05 Jul 2023 2:00 PM EDT
3/3/2023,2023,0,2.142857074737549,30292,Data as Reported to CDC as of 05 Jul 2023 2:00 PM EDT
3/4/2023,2023,6,2.857142925262451,30298,Data as Reported to CDC as of 05 Jul 2023 2:00 PM EDT
3/5/2023,2023,2,2.5714285373687744,30300,Data as Reported to CDC as of 05 Jul 2023 2:00 PM EDT
3/6/2023,2023,0,2.4285714626312256,30300,Data as Reported to CDC as of 05 Jul 2023 2:00 PM EDT
3/7/2023,2023,1,1.8571428060531616,30301,Data as Reported to CDC as of 05 Jul 2023 2:00 PM EDT
3/8/2023,2023,2,1.7142857313156128,30303,Data as Reported to CDC as of 05 Jul 2023 2:00 PM EDT
3/9/2023,2023,2,1.8571428060531616,30305,Data as Reported to CDC as of 05 Jul 2023 2:00 PM EDT
3/10/2023,2023,4,2.4285714626312256,30309,Data as Reported to CDC as of 05 Jul 2023 2:00 PM EDT
3/11/2023,2023,3,2,30312,Data as Reported to CDC as of 05 Jul 2023 2:00 PM EDT
3/12/2023,2023,0,1.7142857313156128,30312,Data as Reported to CDC as of 05 Jul 2023 2:00 PM EDT
3/13/2023,2023,5,2.4285714626312256,30317,Data as Reported to CDC as of 05 Jul 2023 2:00 PM EDT
3/14/2023,2023,2,2.5714285373687744,30319,Data as Reported to CDC as of 05 Jul 2023 2:00 PM EDT
3/15/2023,2023,0,2.2857143878936768,30319,Data as Reported to CDC as of 05 Jul 2023 2:00 PM EDT
3/16/2023,2023,1,2.142857074737549,30320,Data as Reported to CDC as of 05 Jul 2023 2:00 PM EDT
3/17/2023,2023,2,1.8571428060531616,30322,Data as Reported to CDC as of 05 Jul 2023 2:00 PM EDT
3/18/2023,2023,1,1.5714285373687744,30323,Data as Reported to CDC as of 05 Jul 2023 2:00 PM EDT
3/19/2023,2023,1,1.7142857313156128,30324,Data as Reported to CDC as of 05 Jul 2023 2:00 PM EDT
3/20/2023,2023,1,1.1428571939468384,30325,Data as Reported to CDC as of 05 Jul 2023 2:00 PM EDT
3/21/2023,2023,3,1.2857142686843872,30328,Data as Reported to CDC as of 05 Jul 2023 2:00 PM EDT
3/22/2023,2023,0,1.2857142686843872,30328,Data as Reported to CDC as of 05 Jul 2023 2:00 PM EDT
3/23/2023,2023,2,1.4285714626312256,30330,Data as Reported to CDC as of 05 Jul 2023 2:00 PM EDT
3/24/2023,2023,5,1.8571428060531616,30335,Data as Reported to CDC as of 05 Jul 2023 2:00 PM EDT
3/25/2023,2023,1,1.8571428060531616,30336,Data as Reported to CDC as of 05 Jul 2023 2:00 PM EDT
3/26/2023,2023,2,2,30338,Data as Reported to CDC as of 05 Jul 2023 2:00 PM EDT
3/27/2023,2023,3,2.2857143878936768,30341,Data as Reported to CDC as of 05 Jul 2023 2:00 PM EDT
3/28/2023,2023,0,1.8571428060531616,30341,Data as Reported to CDC as of 05 Jul 2023 2:00 PM EDT
3/29/2023,2023,2,2.142857074737549,30343,Data as Reported to CDC as of 05 Jul 2023 2:00 PM EDT
3/30/2023,2023,10,3.2857143878936768,30353,Data as Reported to CDC as of 05 Jul 2023 2:00 PM EDT
3/31/2023,2023,1,2.7142856121063232,30354,Data as Reported to CDC as of 05 Jul 2023 2:00 PM EDT
4/1/2023,2023,2,2.857142925262451,30356,Data as Reported to CDC as of 05 Jul 2023 2:00 PM EDT
4/2/2023,2023,0,2.5714285373687744,30356,Data as Reported to CDC as of 05 Jul 2023 2:00 PM EDT
4/3/2023,2023,3,2.5714285373687744,30359,Data as Reported to CDC as of 05 Jul 2023 2:00 PM EDT
4/4/2023,2023,1,2.7142856121063232,30360,Data as Reported to CDC as of 05 Jul 2023 2:00 PM EDT
4/5/2023,2023,2,2.7142856121063232,30362,Data as Reported to CDC as of 05 Jul 2023 2:00 PM EDT
4/6/2023,2023,4,1.8571428060531616,30366,Data as Reported to CDC as of 05 Jul 2023 2:00 PM EDT
4/7/2023,2023,0,1.7142857313156128,30366,Data as Reported to CDC as of 05 Jul 2023 2:00 PM EDT
4/8/2023,2023,0,1.4285714626312256,30366,Data as Reported to CDC as of 05 Jul 2023 2:00 PM EDT
4/9/2023,2023,0,1.4285714626312256,30366,Data as Reported to CDC as of 05 Jul 2023 2:00 PM EDT
4/10/2023,2023,0,1,30366,Data as Reported to CDC as of 05 Jul 2023 2:00 PM EDT
4/11/2023,2023,0,0.8571428656578064,30366,Data as Reported to CDC as of 05 Jul 2023 2:00 PM EDT
4/12/2023,2023,3,1,30369,Data as Reported to CDC as of 05 Jul 2023 2:00 PM EDT
4/13/2023,2023,2,0.7142857313156128,30371,Data as Reported to CDC as of 05 Jul 2023 2:00 PM EDT
4/14/2023,2023,1,0.8571428656578064,30372,Data as Reported to CDC as of 05 Jul 2023 2:00 PM EDT
4/15/2023,2023,3,1.2857142686843872,30375,Data as Reported to CDC as of 05 Jul 2023 2:00 PM EDT
4/16/2023,2023,3,1.7142857313156128,30378,Data as Reported to CDC as of 05 Jul 2023 2:00 PM EDT
4/17/2023,2023,1,1.8571428060531616,30379,Data as Reported to CDC as of 05 Jul 2023 2:00 PM EDT
4/18/2023,2023,4,2.4285714626312256,30383,Data as Reported to CDC as of 05 Jul 2023 2:00 PM EDT
4/19/2023,2023,2,2.2857143878936768,30385,Data as Reported to CDC as of 05 Jul 2023 2:00 PM EDT
4/20/2023,2023,4,2.5714285373687744,30389,Data as Reported to CDC as of 05 Jul 2023 2:00 PM EDT
4/21/2023,2023,1,2.5714285373687744,30390,Data as Reported to CDC as of 05 Jul 2023 2:00 PM EDT
4/22/2023,2023,0,2.142857074737549,30390,Data as Reported to CDC as of 05 Jul 2023 2:00 PM EDT
4/23/2023,2023,2,2,30392,Data as Reported to CDC as of 05 Jul 2023 2:00 PM EDT
4/24/2023,2023,1,2,30393,Data as Reported to CDC as of 05 Jul 2023 2:00 PM EDT
4/25/2023,2023,1,1.5714285373687744,30394,Data as Reported to CDC as of 05 Jul 2023 2:00 PM EDT
4/26/2023,2023,0,1.2857142686843872,30394,Data as Reported to CDC as of 05 Jul 2023 2:00 PM EDT
4/27/2023,2023,1,0.8571428656578064,30395,Data as Reported to CDC as of 05 Jul 2023 2:00 PM EDT
4/28/2023,2023,1,0.8571428656578064,30396,Data as Reported to CDC as of 05 Jul 2023 2:00 PM EDT
4/29/2023,2023,2,1.1428571939468384,30398,Data as Reported to CDC as of 05 Jul 2023 2:00 PM EDT
4/30/2023,2023,0,0.8571428656578064,30398,Data as Reported to CDC as of 05 Jul 2023 2:00 PM EDT
5/1/2023,2023,5,1.4285714626312256,30403,Data as Reported to CDC as of 05 Jul 2023 2:00 PM EDT
5/2/2023,2023,1,1.4285714626312256,30404,Data as Reported to CDC as of 05 Jul 2023 2:00 PM EDT
5/3/2023,2023,5,2.142857074737549,30409,Data as Reported to CDC as of 05 Jul 2023 2:00 PM EDT
5/4/2023,2023,5,2.7142856121063232,30414,Data as Reported to CDC as of 05 Jul 2023 2:00 PM EDT
5/5/2023,2023,2,2.857142925262451,30416,Data as Reported to CDC as of 05 Jul 2023 2:00 PM EDT
5/6/2023,2023,2,2.857142925262451,30418,Data as Reported to CDC as of 05 Jul 2023 2:00 PM EDT
5/7/2023,2023,3,3.2857143878936768,30421,Data as Reported to CDC as of 05 Jul 2023 2:00 PM EDT
5/8/2023,2023,5,3.2857143878936768,30426,Data as Reported to CDC as of 05 Jul 2023 2:00 PM EDT
5/9/2023,2023,4,3.7142856121063232,30430,Data as Reported to CDC as of 05 Jul 2023 2:00 PM EDT
5/10/2023,2023,1,3.142857074737549,30431,Data as Reported to CDC as of 05 Jul 2023 2:00 PM EDT
5/11/2023,2023,3,2.857142925262451,30434,Data as Reported to CDC as of 05 Jul 2023 2:00 PM EDT
5/12/2023,2023,0,2.5714285373687744,30434,Data as Reported to CDC as of 05 Jul 2023 2:00 PM EDT
5/13/2023,2023,3,2.7142856121063232,30437,Data as Reported to CDC as of 05 Jul 2023 2:00 PM EDT
5/14/2023,2023,1,2.4285714626312256,30438,Data as Reported to CDC as of 05 Jul 2023 2:00 PM EDT
5/15/2023,2023,5,2.4285714626312256,30443,Data as Reported to CDC as of 05 Jul 2023 2:00 PM EDT
5/16/2023,2023,3,2.2857143878936768,30446,Data as Reported to CDC as of 05 Jul 2023 2:00 PM EDT
5/17/2023,2023,1,2.2857143878936768,30447,Data as Reported to CDC as of 05 Jul 2023 2:00 PM EDT
5/18/2023,2023,6,2.7142856121063232,30453,Data as Reported to CDC as of 05 Jul 2023 2:00 PM EDT
5/19/2023,2023,1,2.857142925262451,30454,Data as Reported to CDC as of 05 Jul 2023 2:00 PM EDT
5/20/2023,2023,2,2.7142856121063232,30456,Data as Reported to CDC as of 05 Jul 2023 2:00 PM EDT
5/21/2023,2023,0,2.5714285373687744,30456,Data as Reported to CDC as of 05 Jul 2023 2:00 PM EDT
5/22/2023,2023,3,2.2857143878936768,30459,Data as Reported to CDC as of 05 Jul 2023 2:00 PM EDT
5/23/2023,2023,0,1.8571428060531616,30459,Data as Reported to CDC as of 05 Jul 2023 2:00 PM EDT
5/24/2023,2023,5,2.4285714626312256,30464,Data as Reported to CDC as of 05 Jul 2023 2:00 PM EDT
5/25/2023,2023,4,2.142857074737549,30468,Data as Reported to CDC as of 05 Jul 2023 2:00 PM EDT
5/26/2023,2023,3,2.4285714626312256,30471,Data as Reported to CDC as of 05 Jul 2023 2:00 PM EDT
5/27/2023,2023,4,2.7142856121063232,30475,Data as Reported to CDC as of 05 Jul 2023 2:00 PM EDT
5/28/2023,2023,6,3.5714285373687744,30481,Data as Reported to CDC as of 05 Jul 2023 2:00 PM EDT
5/29/2023,2023,2,3.4285714626312256,30483,Data as Reported to CDC as of 05 Jul 2023 2:00 PM EDT
5/30/2023,2023,2,3.7142856121063232,30485,Data as Reported to CDC as of 05 Jul 2023 2:00 PM EDT
5/31/2023,2023,2,3.2857143878936768,30487,Data as Reported to CDC as of 05 Jul 2023 2:00 PM EDT
6/1/2023,2023,1,2.857142925262451,30488,Data as Reported to CDC as of 05 Jul 2023 2:00 PM EDT
6/2/2023,2023,3,2.857142925262451,30491,Data as Reported to CDC as of 05 Jul 2023 2:00 PM EDT
6/3/2023,2023,2,2.5714285373687744,30493,Data as Reported to CDC as of 05 Jul 2023 2:00 PM EDT
6/4/2023,2023,2,2,30495,Data as Reported to CDC as of 05 Jul 2023 2:00 PM EDT
6/5/2023,2023,4,2.2857143878936768,30499,Data as Reported to CDC as of 05 Jul 2023 2:00 PM EDT
6/6/2023,2023,4,2.5714285373687744,30503,Data as Reported to CDC as of 05 Jul 2023 2:00 PM EDT
6/7/2023,2023,3,2.7142856121063232,30506,Data as Reported to CDC as of 05 Jul 2023 2:00 PM EDT
6/8/2023,2023,1,2.7142856121063232,30507,Data as Reported to CDC as of 05 Jul 2023 2:00 PM EDT
6/9/2023,2023,3,2.7142856121063232,30510,Data as Reported to CDC as of 05 Jul 2023 2:00 PM EDT
6/10/2023,2023,3,2.857142925262451,30513,Data as Reported to CDC as of 05 Jul 2023 2:00 PM EDT
6/11/2023,2023,3,3,30516,Data as Reported to CDC as of 05 Jul 2023 2:00 PM EDT
6/12/2023,2023,2,2.7142856121063232,30518,Data as Reported to CDC as of 05 Jul 2023 2:00 PM EDT
6/13/2023,2023,4,2.7142856121063232,30522,Data as Reported to CDC as of 05 Jul 2023 2:00 PM EDT
6/14/2023,2023,3,2.7142856121063232,30525,Data as Reported to CDC as of 05 Jul 2023 2:00 PM EDT
6/15/2023,2023,4,3.142857074737549,30529,Data as Reported to CDC as of 05 Jul 2023 2:00 PM EDT
6/16/2023,2023,1,2.857142925262451,30530,Data as Reported to CDC as of 05 Jul 2023 2:00 PM EDT
6/17/2023,2023,0,2.4285714626312256,30530,Data as Reported to CDC as of 05 Jul 2023 2:00 PM EDT
6/18/2023,2023,3,2.4285714626312256,30533,Data as Reported to CDC as of 05 Jul 2023 2:00 PM EDT
6/19/2023,2023,3,2.5714285373687744,30536,Data as Reported to CDC as of 05 Jul 2023 2:00 PM EDT
6/20/2023,2023,1,2.142857074737549,30537,Data as Reported to CDC as of 05 Jul 2023 2:00 PM EDT
6/21/2023,2023,1,1.8571428060531616,30538,Data as Reported to CDC as of 05 Jul 2023 2:00 PM EDT
6/22/2023,2023,3,1.7142857313156128,30541,Data as Reported to CDC as of 05 Jul 2023 2:00 PM EDT
6/23/2023,2023,0,1.5714285373687744,30541,Data as Reported to CDC as of 05 Jul 2023 2:00 PM EDT
6/24/2023,2023,1,1.7142857313156128,30542,Data as Reported to CDC as of 05 Jul 2023 2:00 PM EDT
6/25/2023,2023,1,1.4285714626312256,30543,Data as Reported to CDC as of 05 Jul 2023 2:00 PM EDT
6/26/2023,2023,1,1.1428571939468384,30544,Data as Reported to CDC as of 05 Jul 2023 2:00 PM EDT
6/27/2023,2023,4,1.5714285373687744,30548,Data as Reported to CDC as of 05 Jul 2023 2:00 PM EDT
6/28/2023,2023,1,1.5714285373687744,30549,Data as Reported to CDC as of 05 Jul 2023 2:00 PM EDT
6/29/2023,2023,2,1.4285714626312256,30551,Data as Reported to CDC as of 05 Jul 2023 2:00 PM EDT
6/30/2023,2023,1,1.5714285373687744,30552,Data as Reported to CDC as of 05 Jul 2023 2:00 PM EDT
7/1/2023,2023,1,1.5714285373687744,30553,Data as Reported to CDC as of 05 Jul 2023 2:00 PM EDT
7/2/2023,2023,0,1.4285714626312256,30553,Data as Reported to CDC as of 05 Jul 2023 2:00 PM EDT
7/3/2023,2023,1,1.4285714626312256,30554,Data as Reported to CDC as of 05 Jul 2023 2:00 PM EDT
7/4/2023,2023,0,0.8571428656578064,30554,Data as Reported to CDC as of 05 Jul 2023 2:00 PM EDT
7/5/2023,2023,0,0.7142857313156128,30554,Data as Reported to CDC as of 05 Jul 2023 2:00 PM EDT